30x8
.....................s........
.....................s........
...........ssss.....ss........
.........ss...ss...ss.........
.........s.....s...s..........
................s.............
................s.............
................s.............
.ot l
