40x40
1111111111000000000000000000000000000000
1111010111100000000000000000000000000000
1111111111110000000000000000000000000000
1100000011111000000000000000000000000000
1110000111111111111111111101111111111111
1111111111111111111111111101111111111111
1111111111111111111111111101111111111111
1111111111111111111111111101111111111111
1111111111111111111111000001111111111111
1111111111111111111111011111111111111111
1111111111111p00000000011111111111111111
1111111111111330000000011111111111111111
1111111111111000000000011111111111111111
1111111111111000000330011111111111111111
0000000000000000000000000000000000000000
0000000000000000000000000000000000000010
000000000000000000000t000000000000000010
0000000000000000000003300000000000003310
0000000000000000000000000000000000003010
0000000000000000000000000000000000000010
0000000000000000000000000000000000000010
0111111111111111111111111144444444444411
0110000110000110000111111111111111111111
0110001101111101111111111111111111111111
0110111101100101100111111111111111111111
0110000110000110000101111111111111111111
0111111111111111111111111111111111111111
0111111111111111111111111111111111111111
0111111111111111111111111111111111111111
0111111111111111111111111111111111111111
0111111111111111111111111111111111111111
0111111111111111111111111111111111111111
0111111111111111111111111111111111111111
0111111111111111111111111111111111111111
0111111111111111111111111111111111111111
0111111111111111111111111111111111111111
0111111111111111111111111111111111111111
0111111111111111111111111111111111111111
0111111111111111111111111111111111111111
0111111111111111111111111111111111111111
